111111111111111111111111
1000000C100000000000C1E1
100000111000000011111101
100000000C00000000000001
1P0000001000000000000111
100000001C100000000000C1
111111111111111111111111
