11111111111111111111
10000000000000000001
10011111100111100001
10010000100100010001
10011111100100001001
10010000000100001001
10010000000100010001
10010000000111100001
10000000000000000001
11111111111111111111
