NO ./texture/owl.xpm
SO ./texture/dragon.xpm
WE ./texture/tree.xpm
EA ./texture/wall.xpm

F 220, 100, 0, 15
C 25,0,255

        1111111111111111111111111
        1000000000110000000000001
        1011000001110000000000001
        1001000000000000000000001
111111111011000000110000000000001
100000000011000000110111111111111
11110111111111011110000010001
11110111111111011101010010001
11000000110101011100000000001
10000000000000001100000000001
10000000000000001101010010001
11000001110101011111011110N0111
11110111 1110101 101111010001
11111111 1111111 111111111111
