NO ./texture/owl.xpm
SO ./texture/grass.xpm
WE ./texture/tree.xpm
EA ./texture/wall.xpm

F 220,100,0
C 25,0,255

        1111111111111111111111111
        1000000000110000000000001
        1011000001110000000000001
        1001000000000000000000001
111111111011000000110000000000001
100000000011000000110111111111111
1111011111111101111000001000
1111011111111101110101001000
1100000011010101110000000000
1000000000000000110000000000
1000000000000000110101001000
11000001110101011111011110N0111
11110111 1110101 101111010001
11111111 1111111 111111111111